6-6-2-6-0-0-0-0-6-6-6-3-3-5-5-5
6-6-2-6-0-0-0-0-6-6-6-3-3-5-5-5
6-6-6-6-6-6-6-6-6-6-6-6-6-6-6-6
6-6-2-0-0-0-0-0-0-0-0-3-3-2-6-6
2-2-2-0-0-0-0-0-0-0-0-3-3-2-6-6
0-0-0-0-0-0-0-0-0-0-0-3-3-2-6-6
3-3-3-3-3-3-3-3-3-3-3-3-3-3-6-6
4-4-4-4-4-3-4-4-4-4-4-0-0-2-6-6
4-4-7-7-4-3-4-4-4-4-4-0-0-2-6-6
4-4-7-7-4-3-4-4-4-4-4-0-0-2-6-6
4-4-4-4-4-3-4-4-4-0-0-0-0-2-6-6
0-0-0-0-0-3-4-0-0-0-0-0-0-2-6-6
0-0-0-0-0-3-0-0-0-0-0-0-0-2-6-6
0-0-0-0-0-3-0-0-0-0-0-0-0-2-6-6